50
oo...o.....oo....................oo..............o
.o...........o..o.......ooo.......o.....o..ooo....
.....o..o....o.oo.oo....o...o..o..o.oo..o.oo....oo
o.o.....oooo...o......o.o.....o...o..o...o........
.......o.o...o......o..o.o...o.o..o..o....oo......
.......o.......o.o.......ooo.....o.......o.....oo.
..o...o.............o...o......o..o.............o.
............o...............ooo.....o...o..o...o..
o.oo........o..........oo..o......o...........o.o.
...o..oo.....o.....oo.o..o.oo...o............o....
o....o.o.o...o..o.....o..o.....o...oo...o.........
........oo..............o..o.o...o...oo.oo.ooo....
............o.................o.....o.o.........oo
....oo.......o.........o..oo....o.....o........o.o
o..o......o..o.o..o.......o...o...o.....o..o.o.o..
...oo....o.....o......o...oo...........oo.o.......
..o..........o..o.....o..o...o.o.o..........o.o.o.
.......oo..o.o....o....oo...o..o...ooo..oo.o.....o
o...o................oo..o...o........oo.....o....
.oooo......ooo.......oo.............o.....o....o..
.o.o...........oo.o...o....o.o.o........oo........
....o........o.oo...o......o.o.o...........o......
...o....oo.....o.o.ooo......o.o.............o.....
...........oo..o..oo.o.....o..o......o.o.o.o......
.o.o.o.....o.oo.o...o..............o.o..o.oo..o..o
....o.......o...o..o.......oo..o.......o.....o.o..
o.oo.oo.o..o..o......o..o.....o..........o......o.
........o.......oo............o...o...............
..o..o........oo.........oo.oo.o...ooo..........oo
...oo........o......o....o...................o....
oo.........o..o......o......o.....o..oo....o....o.
.......o...oo..o.....o..o.....o........o.....o.o..
.o.oo..o.oo.............oo.oo......o..........oo.o
........o....o.o......oo.o...oo..........o..o..o..
.oo..o.o.o......o.o............oo...o.............
...oo.o...o......o.....o....o.......o....o.....oo.
..o..........o...oo.o..o..o..o..........o.....o.o.
...o..o....oo..o...........oo...o.o...o....o.o...o
.....o...o..........ooo.....o...o.o.o.o..oo.ooo..o
...o................o...o.oooo..........o.oo.o.o..
..o........ooo....oo.o.........o.o..o......oo.o...
o.......o...oo..o.o.....o..o.....o.....o..ooo..o..
.......o.........o..............o.o............o.o
.o....oo...o.....o.oo.....o...o.............oo...o
...oo............o.o....o.oo.oo.o...o.o..o...o..oo
ooo.o..o.o.oo..o......o.....o..oo..o.......o...o..
.o.o..oo.o.....o.o.....o....o......o..o.oo.....o.o
..ooo......o.....oooooooooo.o...o......o...o..o...
.........o.oo.o....oo..o...o.....o..o..........o..
o........o..o.o....o.o...oo.oo.oooo.......o..o.oo.
